CGACTCTCCTC	HAMMERHEAD
ATGAAGCAGTTTTAC	HAMMERHEAD
CCCCCCTCAT	HDV
AGCGAAATCA	HDV
CCAGTCATCAGGCGA	HDV
CATGGGATTTAT	GROUP_I
ATTGGAGGGTACCGG	GROUP_I
GTGCCAGCTT	GROUP_I
CACAATTAGTG	HDV
TTCTCCGATCT	GROUP_I
TGAGGGGAGAATGG	HAMMERHEAD
AAAGCGACATC	HAMMERHEAD
GCACGAGAAGTGCG	HDV
GGTAGTTTTAGGC	HAMMERHEAD
CAAACCTCAGTCGGA	HDV
CTATTGATCCTTCTG	GROUP_I
GCGCAGGCCACCCAA	HAMMERHEAD
CGGCACTGCCCTG	GROUP_I
CAAGTGGTAGT	GROUP_I
CCGCTCCGGGGATT	HAMMERHEAD
GTGCGCCATTGG	HDV
AAGGAACATTTC	HDV
TGCCCGGGTCG	HAMMERHEAD
GTTACACTCTAT	HDV
CCTCATTCAATCCT	HAMMERHEAD
CCGTTGATTAC	HDV
CCTCCTCCATA	HAMMERHEAD
GTCGTGTGCGT	GROUP_I
CCGGGGTATTG	GROUP_I
TTACATATATACG	HDV
CTAGTTTCCCAA	HDV
GTAACCGGCCC	HAMMERHEAD
ATTACGCTATAGCG	HDV
TGTTCCGCAC	HAMMERHEAD
TTCCCCAGTAC	HAMMERHEAD
TGTCCTGGGTTCTC	HAMMERHEAD
CAGACGCGGAAGG	HAMMERHEAD
ATGTACATAT	GROUP_I
ACATGAAGTCTTT	HDV
TATTTAGAAATGG	GROUP_I
TGATAGCTGGGGTG	HDV
ATTATCAGAGCC	GROUP_I
CCGTACCCCCCGGCT	GROUP_I
GCTTTCTGAGGC	GROUP_I
GCTTCCAGGACGA	GROUP_I
TTAGTGCCTCGC	HAMMERHEAD
TTACCAGTACGCC	GROUP_I
TGGCTCTCACACGGC	HDV
TAACGTAGTC	HAMMERHEAD
AACTGGTCGGC	HDV
TCCCAAATTA	HAMMERHEAD
TAGGCGAGAGTATAC	HDV
TCGCTCGTCCACCT	GROUP_I
ATATTCCGTGTATC	HAMMERHEAD
TATAACACGT	HAMMERHEAD
AGTGAATAAACTGCG	HAMMERHEAD
GGCTACGGATGCG	GROUP_I
ATGTGAACCGTCA	HAMMERHEAD
GTATGATATACC	HDV
CACATAGGACAG	HAMMERHEAD
GAAATACGGTTTAT	GROUP_I
CTTCAAGCCATACC	HAMMERHEAD
CTTATGTATGTCCG	HAMMERHEAD
TGTGAAGGGAT	GROUP_I
GAGCGATCTC	HAMMERHEAD
CAGGATGGGCAACGA	HAMMERHEAD
CGTCCGCTTGTT	HDV
GCAATTCGACTGA	HDV
CGAAGGTGCCCA	HDV
ACCGTGTTGTGGT	HAMMERHEAD
GCTACCGGAC	GROUP_I
GGCAACCAGTTCTG	HAMMERHEAD
CGCGTAGCCCGA	HAMMERHEAD
GTATCCGCAAAATTC	HAMMERHEAD
TCGGCTGTAA	HDV
GTAGGTCGCGCCT	GROUP_I
CGCCGCGTTCTTAC	HAMMERHEAD
ATCGCCCATTGT	HDV
ATTGCCATTTTCG	HDV
GTCATACGCCGT	HDV
CATATAGTTC	GROUP_I
CCCTTACGAC	HAMMERHEAD
TTGCGCATGCACCCG	HDV
TGTGGATTCG	HDV
TGTGGGACTC	HAMMERHEAD
ACCCTTTTGTGGTC	GROUP_I
CTCAACAAGA	GROUP_I
ACCTATAATC	GROUP_I
TCATTTCCGCTCA	GROUP_I
ACTGCGCCCGGACCG	HAMMERHEAD
ATAAACACACTGACG	HDV
GGTCGCTCTGAGAG	HAMMERHEAD
AACGAACAAGTCTCT	HDV
CATGCTTCGGCTTA	HDV
ACTCCGCTGGTTAT	HDV
ATCAGCATGATA	HDV
ATCGAAAATTTTG	HDV
CGAGGATCGACA	HDV
AAATGAGATTG	HDV
TCATAGTCCTTTTAT	HAMMERHEAD