ATATGCGAGC	ENV
GCCCTCTATGCA	POL
ACGGTGTGTA	GAG
CGACTTGACGTA	ENV
CCGGGCAGCCGCCGA	GAG
CTTTTGTCTAGCG	GAG
CCAATTGCAG	ENV
AGCCGCGTCCAG	POL
ATCGTACTCCGG	GAG
GACTCAATGGCAGCC	GAG
TTAAAACATA	GAG
ATTCCCCAGTAAAC	GAG
CTTTGTAAGT	POL
CCTCGAACCTGACC	POL
GTCACTAACT	POL
GCCATCTAGA	GAG
CATAGAACCTTCGTA	GAG
TATCACGCGGCACGG	ENV
TACATGAACCAT	ENV
CGGAAGATCAC	GAG
TCGCATCTCATTC	GAG
GGAAGGGCTC	GAG
TGGAAGTCGGA	GAG
ACTTACTTAAG	POL
CCGGGCTCTCC	ENV
GTTTGCACTGAC	GAG
CAAAATCTTC	ENV
GAACGGATACT	ENV
AAGGCCTCAGGCGG	POL
CAAATGAGCGG	POL
AGGCCGGGTAGAC	ENV
GCGGTGCGCGCTGC	POL
GCAACGGTGAGAACA	GAG
CGATGGCAACCACG	POL
TCATGAGCCTAC	ENV
GACTTATAGCG	ENV
ACCATTGAACACAT	GAG
AGTTAAGGTG	POL
TTTTGACGATA	ENV
CTCGAGCAAGAGCTA	POL
AGGTTCCGAGA	GAG
CTATGTTAGAG	ENV
GTAATGAGTGGTG	GAG
CGGGCACCACG	GAG
AACACCGGAAGCCCA	POL
AGCGGGCAAGCAAGC	ENV
AGGTGGATTAT	ENV
ATAATCTTGGCCTC	POL
TCGCTCTACCTTTCT	GAG
AGATTCATTAG	ENV
AAAACCAACGG	GAG
AAAACGAAACCTAG	ENV
CCCACTATGA	POL
AGCTTGAGGAGTC	GAG
TGATCTGCAT	ENV
CGTTGGGGTCGTTA	GAG
ACTTTGGGTTTGT	GAG
TTAGCAGGCGAATG	ENV
TACCAAGCAACTCG	GAG
TTGTTACTACCAAA	GAG
CTCGCAGCGTCA	ENV
ATAGGATAGGCGAGA	ENV
TACGCGGGCGCCAT	POL
TCAGCTGTTGC	GAG
TTCCAAAGGTCGACT	GAG
AAAGGACTAAAC	POL
ATATCCCAGTGG	GAG
GATCGCCCTTAG	ENV
TGCCGCTAGCAT	GAG
CACTGAGATGCTATA	ENV
CGTCCCCCTGG	POL
TCGTTTCAACTGGT	ENV
CGGAGTCGATCA	GAG
TACAGGTATA	POL
GCCTTTTAAC	ENV
CTTCCCTTAACCACT	POL
CGGAGGCGATCA	POL
CGTTAAATATTA	GAG
CACGGTCATAGGGT	POL
CTGAAACTTCGT	ENV
TACATACCACTTCTA	ENV
ACCCATTTCGCAT	ENV
TCGCACATACTTAG	POL
TGGTGCTTGT	ENV
TCTCTCCCCTTCCAC	POL
CGACGTGCGAGAA	POL
TAGTTTTGTCGCTC	GAG
CTTTAATGCGGGA	ENV
GACTGGCGGGGGCG	GAG
TATGAGGGCCTCACT	POL
AGCATGTGCTCTGG	POL
TCATAAACTA	GAG
AAATATCGTT	GAG
GCACACAGAGACCAG	POL
AACTAGTCTTCGA	GAG
ATGACCCGAAGACG	ENV
ATCCTGTTAA	ENV
TAAGACTTAAAAA	GAG
ACAGTATGAG	POL
AACTATAGCGTCGT	GAG